NO ./inc/NO.xpm
SO ./inc/SO.xpm
WE ./inc/WE.xpm
EA ./inc/EA.xpm


F 	255, 255,0
C 0,0,     255
                               1111111
                               110111
        1111111111111111111111110101
        1000000000110000000000S011111
        1011000001110000000000001
        1001000000000000000000001       
111111111011000001110000000000001       
100000000011000001110111111111111      
11110111111111011100000010001
11110111111111011101010000001
11000000110101011100000010001
10000000000000001100000010001
10000000000000001101010010001
11000001110101011111011110001
11110111 1110101 101111010001
11111111 1111111 1111100000111
111111111111111111111111111111