NO ./inc/NO.xpm
SO ./inc/SO.xpm
WE ./inc/WE.xpm
EA ./inc/EA.xpm

F       	0, 255,  0
C      0,0, 255


1111111111111111111111
100000000E000000000001
1111111111111111111111