NO ./inc/NO.xpm
SO ./inc/SO.xpm
WE ./inc/WE.xpm
EA ./inc/EA.xpm
F                 10,100,0
C             25,20,44


1111111111
1111111111
10000W0001
1001111111
1111111111